
F 2,2,255
NO ./path_to_the_north_texture
EA ./path_to_the_east_texture

SO ./path_to_the_south_texture
C 255,90,0
WE ./path_to_the_west_texture

11                     111
                111111
        1
        111111111111111111111111
 11     1011000001110000000000001
        1000000000110000000000001
        1001000000000000000000001
111111110011000001110N00000000001
100000000011000001110111111111111
1111111111111111110111
                111111     11
                           111111
                                111