
F 2,2,255
NO ./path_to_the_north_texture
EA ./path_to_the_east_texture

SO ./path_to_the_south_texture
C 255,90,0
WE ./path_to_the_west_texture

                    111
                111111
        111111111111111111111111111111111111
        1011001110N0000000101
        111111111111111111111111111111111111
        111111111111111111111111